11111
1P0C1
10E10
11111

11111
1P0C1
10E10
11111
